Name,Volume,Ask Size,Ask Price,Bid Size,Bid Price,Last Price,Shares Matched,Shares Routed
UVXY,10896714,4400,10.22,3005,10.20,10.22,10829039,67675
VIXY,1524524,4600,14.54,100,14.52,14.53,1515569,8955
UVIX,925801,6100,10.50,3105,10.46,10.50,863826,61975
USHY,659476,100,42.13,20,35.80,35.84,614810,44666
IEFA,564406,1,60.99,1,59.50,59.97,558402,6004
SVXY,506201,100,53.40,100,53.35,53.38,500680,5521
ARKG,505905,1,36.54,200,35.80,36.19,502641,3264
ITB,494867,100,64.06,2,54.99,58.80,492984,1883
GOVT,304127,100,27.95,100,19.59,23.74,303045,1082
IGV,271386,100,346.96,5,290.00,294.83,263914,7472
VXX,267183,100,21.12,10,21.11,21.12,260693,6490
SVIX,241483,200,12.64,10500,12.62,12.63,237823,3660
EZU,210668,100,43.03,1,36.12,36.18,205496,5172
USMV,189640,100,89.21,70,73.08,74.77,184840,4800
INDA,189498,20,44.50,37,42.60,42.69,186801,2697
BBEU,167426,200,58.88,200,35.34,46.33,166876,550
EFV,155332,100,50.62,5,40.00,43.29,154732,600
MTUM,152748,1,147.00,100,115.35,145.45,152476,272
VLUE,146398,100,112.81,100,79.18,95.82,145749,649
CBOE,134181,100,145.21,15,122.07,123.63,133526,655
JPST,131915,700,50.20,2500,50.18,50.19,131915,0
ITM,97728,200,57.55,100,38.08,45.93,92244,5484
IDV,91747,100,33.83,2,27.10,27.10,91578,169
COWZ,83378,23,50.00,25,44.97,46.68,83023,355
QUAL,81673,5,126.10,100,100.65,121.54,80721,952
EFAV,81460,100,79.41,100,50.06,64.07,80683,777
ECH,81187,100,33.19,100,19.07,25.87,79698,1489
FAUG,71772,200,46.05,200,27.63,36.27,71772,0
REM,69551,100,33.98,239,27.50,28.93,69151,400
PAVE,68981,1,27.28,5,26.40,26.58,67780,1201
FLOT,61302,100,58.95,20,50.20,50.28,61268,34
ENOR,52738,200,40.02,1,26.00,26.48,52738,0
BBJP,52383,200,58.03,100,38.05,45.95,49603,2780
ICSH,45394,100,58.65,100,41.51,50.08,45133,261
IYZ,42848,100,30.82,1,25.71,25.85,42748,100
GVI,42763,100,130.42,100,82.21,105.31,42763,0
MOAT,40838,10,76.67,10,57.60,69.79,40746,92
AAAU,39281,10900,17.24,800,17.22,17.23,39181,100
NOBL,38430,5,92.78,8,92.00,92.07,38430,0
VIXM,37459,300,33.50,300,31.79,33.50,37419,40
EFG,34603,100,103.61,100,65.31,83.55,32206,2397
ARKQ,32819,11,56.17,200,54.00,54.35,32819,0
IGE,31337,100,45.72,100,32.00,38.92,30996,341
FBCG,31161,100,32.20,100,20.40,25.05,25662,5499
BBAX,31114,200,61.32,200,36.80,48.72,28810,2304
BBCA,29085,100,75.82,100,48.00,61.50,19277,9808
IEO,29053,125,97.30,1,89.00,91.22,28653,400
HYD,28906,100,65.44,100,44.73,53.97,28630,276
JMST,27527,100,62.57,100,41.87,50.50,27413,114
FGRO,24672,100,20.41,100,9.92,14.72,24672,0
RPHS,24563,200,13.53,200,4.51,8.88,24563,0
PAUG,23748,1700,29.17,100,21.81,29.17,23181,567
DFIC,22470,200,33.46,200,11.16,21.92,21370,1100
IYJ,22060,100,116.28,100,80.00,98.35,22054,6
IYT,21896,100,283.00,100,192.47,239.37,21859,37
DRSK,21558,100,34.49,100,20.07,26.82,21558,0
ESGV,20409,70,78.50,20,65.00,73.06,20409,0
PICK,20100,100,47.94,200,36.94,37.28,20100,0
TAIL,19926,100,19.84,100,13.39,16.37,19823,103
ITA,18906,5,104.89,50,104.32,104.45,18234,672
CEMB,18782,200,54.51,200,32.71,43.50,18738,44
ARKX,18015,100,17.35,461,14.67,14.75,17969,46
OILK,17814,1300,49.74,100,48.36,48.78,17814,0
LQDI,17769,200,33.67,200,20.21,26.92,17769,0
EEMV,16961,100,76.10,100,46.06,55.58,15873,1088
CALF,16734,100,49.45,100,28.76,38.51,16734,0
VUSB,15632,787,49.35,400,49.23,49.26,15332,300
IAGG,15121,200,63.05,200,37.83,50.30,14747,374
MLN,14358,200,22.70,100,14.25,18.15,12804,1554
SECT,13879,200,59.65,1,38.89,39.77,13779,100
GCOW,13858,100,39.27,10,30.50,30.56,13858,0
LVHI,13644,100,33.95,100,19.75,26.41,13644,0
HEFA,13090,200,41.16,200,24.71,32.55,13090,0
SHYD,12210,100,31.51,100,15.31,22.72,12210,0
ACWV,11825,100,121.85,2,90.50,98.32,10837,988
NEAR,11703,800,49.36,500,49.33,49.35,11703,0
KNG,11700,100,65.42,200,26.82,52.81,11700,0
VNM,11654,125,15.40,50,15.25,15.28,11494,160
SLVP,11328,100,10.69,1,8.90,9.06,10964,364
IGRO,11296,100,70.84,200,28.97,57.26,11296,0
ICVT,11285,200,93.66,100,58.03,74.03,11285,0
VSGX,11283,100,60.89,100,36.99,49.48,11149,134
DFIS,11264,200,32.62,200,10.88,21.24,11264,0
AUGZ,11106,200,48.01,200,16.01,31.47,11106,0
FJUN,11094,200,56.25,200,18.75,37.15,10773,321
FFEB,10516,100,46.86,100,27.26,36.39,10516,0
PJAN,10513,100,40.58,100,23.61,31.60,10513,0
MAMB,10414,100,31.13,100,15.13,22.42,5978,4436
IFRA,10377,10,38.29,100,25.33,37.98,10347,30
PTMC,10004,200,51.82,100,28.00,33.82,10004,0
BBUS,9826,100,92.07,100,58.04,74.34,8492,1334
FCPI,9805,100,38.64,100,23.77,31.85,9805,0
NULG,9454,100,66.38,200,27.49,53.60,9454,0
DFEB,9397,200,52.47,200,17.50,34.58,9297,100
NUDM,9342,200,38.88,200,12.96,25.48,9342,0
DIHP,8688,200,33.57,200,11.19,22.02,8688,0
EMGF,8554,200,54.15,200,32.49,43.09,7354,1200
PMAR,8420,200,47.23,200,15.75,31.08,8420,0
ESML,8256,200,53.86,100,26.95,35.15,8060,196
ICF,7941,10,71.00,100,52.75,64.79,7725,216
NULV,7913,100,45.69,100,26.58,35.55,7913,0
DMAY,7905,200,48.60,100,24.00,32.14,7905,0
EMHY,7529,200,43.63,200,26.19,34.61,7336,193
QMOM,7357,200,73.48,200,24.50,48.91,7357,0
BALT,7318,100,33.68,200,13.13,26.19,4892,2426
DAUG,7296,200,40.61,200,24.37,32.20,7296,0
GHYG,7289,200,52.61,15,38.70,41.44,7089,200
FLHY,7251,200,28.72,200,17.24,22.69,7251,0
UJAN,7244,100,38.15,100,22.19,29.69,7244,0
DIVB,7223,40,39.88,4,39.00,39.08,7222,1
CNYA,7172,200,43.47,100,27.11,34.97,7172,0
XVOL,6775,100,24.29,100,12.96,19.22,6775,0
SYLD,6687,100,75.56,100,47.63,60.90,6687,0
XMPT,6445,50,23.74,50,23.42,23.55,6445,0
OUSA,6437,500,42.90,100,34.86,42.28,5991,446
IBHI,6416,200,34.62,200,11.54,22.92,6416,0
PBTP,6402,200,32.26,200,19.36,25.80,6402,0
XBJL,6388,100,33.36,200,13.12,25.96,6388,0
IBMN,6262,100,31.06,100,21.92,26.50,6262,0
FDRV,6098,200,30.02,100,15.76,19.30,6097,1
IZRL,6025,100,27.30,100,14.68,19.77,6025,0
NOCT,5998,200,57.14,200,19.05,37.80,5998,0
IYLD,5860,200,25.22,100,16.46,20.02,5860,0
FYLD,5851,100,32.65,100,18.24,23.57,5851,0
PRNT,5836,17,22.69,100,16.98,22.69,5836,0
PTLC,5776,100,48.33,100,28.12,37.59,5776,0
UAPR,5347,100,32.77,200,12.86,25.41,3788,1559
DISV,5312,200,32.53,100,17.51,21.18,5312,0
CEFS,5306,100,23.39,100,12.64,18.76,5306,0
IEFN,5160,100,39.86,100,23.18,31.08,4691,469
HEGD,5148,200,22.16,200,13.30,17.55,5148,0
ADME,5146,100,47.17,100,27.44,36.70,5146,0
LKOR,5067,200,56.83,200,34.10,44.91,5067,0
ZECP,5066,200,37.10,200,12.37,24.25,5066,0
FDG,4956,100,75.18,100,47.40,60.76,4956,0
HYDB,4932,200,57.16,200,34.30,45.20,4926,6
FBCV,4883,100,36.34,100,21.14,28.30,4583,300
TMFG,4858,100,38.64,200,13.17,25.74,4858,0
FMAG,4850,200,31.87,100,10.96,20.76,4849,1
BJAN,4830,200,52.29,200,17.43,34.46,4830,0
BUFR,4788,100,27.51,100,18.24,22.73,4788,0
IECS,4730,100,44.59,100,25.94,34.68,4467,263
NUMG,4631,200,59.02,200,19.68,38.31,4531,100
NUSC,4598,100,46.96,100,27.32,36.57,4598,0
JPIB,4588,200,57.97,200,34.79,46.17,4410,178
MBCC,4487,200,37.89,200,12.64,24.85,4487,0
BMAR,4400,200,50.43,200,16.81,33.13,3400,1000
IEIH,4353,200,51.20,100,24.87,34.18,4254,99
IQDG,4346,200,38.85,100,24.97,30.52,4046,300
BAUG,4315,100,40.44,100,23.53,31.47,4015,300
SMMV,4279,100,46.84,200,18.33,36.06,3965,314
XBTF,4249,500,20.48,100,20.39,20.40,4199,50
OMFL,4221,100,56.64,100,32.94,44.08,4221,0
NUEM,4187,200,40.50,200,13.50,26.74,4062,125
XVV,4186,200,39.91,100,25.79,31.23,4186,0
GSST,4124,100,58.99,200,37.44,49.92,4124,0
FCTR,4074,100,34.77,100,24.55,29.65,4074,0
BUFG,4004,200,28.42,200,9.48,18.70,4004,0
POCT,3995,100,37.53,100,21.83,29.16,3995,0
IDME,3968,200,30.21,100,13.46,19.93,3868,100
WTAI,3925,200,25.85,200,8.62,16.71,3925,0
REGL,3902,200,111.45,1,70.61,72.85,3902,0
KJAN,3899,100,39.01,100,22.70,30.28,3899,0
DDLS,3718,200,39.48,200,23.70,31.11,3718,0
FRNW,3714,200,37.72,200,12.58,24.68,3714,0
SMDV,3637,100,78.83,100,49.70,63.68,3584,53
UMAY,3590,100,34.89,100,20.30,27.15,3590,0
MPRO,3586,100,33.61,200,13.23,26.17,3586,0
MOHR,3576,200,30.73,100,16.73,20.22,3576,0
APXH,3575,200,12.98,200,4.33,8.57,3575,0
AGT,3538,200,32.97,200,19.79,26.40,3538,0
VXZ,3498,300,28.35,300,28.10,28.33,3498,0
IVAL,3494,100,32.05,100,15.57,23.16,3494,0
JEMA,3451,100,46.26,100,29.72,35.93,3451,0
DDEC,3414,100,39.60,100,23.03,30.84,2999,415
QLC,3404,100,59.03,100,34.33,45.89,3404,0
FLDR,3293,100,61.64,100,41.22,49.74,2993,300
SMIN,3292,100,65.86,14,53.00,53.13,3292,0
FJAN,3248,100,42.87,100,24.93,33.19,3248,0
OGIG,3239,100,35.20,30,29.00,29.33,3084,155
RULE,3202,200,30.39,200,10.14,20.09,3202,0
XTJL,3135,200,36.43,200,12.15,24.03,3135,0
QTJL,3009,100,28.98,200,10.95,21.54,3009,0
BFEB,2959,200,46.51,200,15.51,30.56,2959,0
ADFI,2898,200,12.93,200,4.32,8.62,2898,0
JCPB,2896,200,60.55,200,36.33,48.30,2746,150
EMTL,2863,200,52.55,200,31.54,41.72,2863,0
FLQL,2819,1,46.00,100,31.24,41.81,2819,0
USEP,2800,100,34.13,100,19.86,26.56,2600,200
BSEP,2751,100,40.58,100,23.61,31.58,2751,0
HYIN,2728,100,29.71,48,20.70,20.75,2610,118
FLV,2725,100,73.32,100,46.23,59.17,2725,0
USMF,2599,100,49.83,5,38.57,38.77,2599,0
JPHY,2568,200,57.10,200,34.26,45.18,2568,0
IBHB,2559,200,36.01,200,12.01,24.05,2159,400
MRGR,2547,100,51.72,100,30.09,40.23,2547,0
IBHD,2542,200,34.23,200,11.41,22.79,2442,100
DMAR,2537,100,40.01,100,25.68,31.07,2537,0
PBEE,2510,100,31.51,100,15.31,22.69,2510,0
SVAL,2506,100,38.03,100,22.12,29.61,2106,400
QDEC,2504,100,28.56,100,13.87,20.55,2504,0
XSHQ,2504,200,53.55,200,17.86,34.81,2504,0
EYLD,2494,100,35.45,100,20.63,27.59,2494,0
FLQM,2494,200,65.66,100,32.09,42.94,2494,0
TDV,2481,100,73.74,100,46.50,59.45,2431,50
TOKE,2466,200,12.06,2,7.85,7.91,2466,0
FFTI,2427,200,32.00,100,17.56,21.27,2427,0
IBMP,2381,200,31.66,200,19.00,25.25,2381,0
STOT,2379,200,58.35,200,35.01,46.63,2379,0
HYHG,2321,100,72.88,100,48.09,58.86,2321,0
FCLD,2306,200,26.15,100,12.86,16.91,1656,650
XSHD,2304,200,30.43,100,13.96,19.82,2304,0
VFQY,2262,100,135.49,100,85.42,108.99,1862,400
GTIP,2253,100,61.21,100,43.30,52.26,2253,0
PSFF,2225,200,33.07,200,11.03,21.83,2225,0
IBMQ,2216,200,31.56,200,18.95,25.17,2216,0
DURA,2176,200,47.58,100,17.85,31.19,2176,0
PTNQ,2163,200,81.24,100,42.60,53.21,2063,100
PAPR,2148,100,36.61,100,21.30,28.45,2148,0
UJUN,2134,100,35.59,100,20.71,27.76,2134,0
ATMP,2120,200,29.19,200,9.74,19.36,820,1300
IBHC,2110,100,29.27,100,15.82,23.50,2110,0
VOTE,2093,100,61.80,100,35.95,48.10,2093,0
IBMM,2092,200,32.34,100,21.39,25.86,2092,0
EPRF,2082,100,28.66,100,13.63,20.21,2082,0
TMFC,2027,100,42.63,1,35.71,35.85,1686,341
DFNL,2021,100,35.17,100,20.46,27.32,2021,0
FSEP,2013,200,51.03,100,25.30,33.81,2013,0
BBRE,2008,100,111.56,100,77.00,94.22,1858,150
YJUN,2000,100,24.75,100,12.03,17.79,1000,1000
SMB,1956,200,21.13,100,13.99,16.93,1956,0
NUMV,1931,200,51.24,200,17.08,33.39,1931,0
TYA,1925,200,22.63,200,13.59,17.94,1727,198
OMFS,1914,100,46.79,100,27.21,36.29,1755,159
BBIN,1881,100,61.91,100,36.01,48.19,1881,0
HYMU,1873,200,27.96,200,16.79,22.37,1873,0
SEPZ,1852,200,46.17,200,15.40,30.68,1852,0
FOCT,1849,100,43.12,100,25.08,33.45,1849,0
WUGI,1849,200,63.21,200,21.08,40.89,1849,0
VCEB,1844,200,79.46,200,47.68,63.18,1844,0
EFNL,1819,100,44.91,1,34.50,34.89,1819,0
FPRO,1787,200,35.91,100,15.81,23.48,1787,0
BUFD,1774,200,30.42,200,10.14,20.07,1774,0
VFMF,1762,100,123.84,100,78.76,99.69,1762,0
FLBL,1756,200,30.13,200,18.09,23.98,1756,0
PTEU,1753,100,31.04,100,15.08,22.37,1753,0
GAA,1751,200,41.31,1,25.90,27.25,1751,0
FRDM,1749,200,42.69,1,25.94,28.25,1749,0
IBML,1747,100,29.73,100,20.98,25.37,1747,0
IBHH,1720,200,34.87,200,11.63,23.11,1720,0
DALT,1710,100,12.79,200,4.66,9.27,1710,0
TMAT,1706,100,19.95,100,9.70,14.38,1606,100
QVAL,1649,100,43.50,100,25.30,33.89,1649,0
WFHY,1621,200,57.86,200,34.72,45.72,1621,0
UFEB,1607,200,40.81,100,20.17,26.91,1607,0
IEHS,1585,100,49.29,100,31.13,41.45,1585,0
FMAY,1549,200,55.57,200,18.53,36.57,1549,0
BOCT,1542,200,48.94,200,16.32,32.30,1542,0
HEEM,1542,200,31.84,200,19.11,25.35,1442,100
NETZ,1522,200,78.24,200,26.09,51.38,1122,400
DSEP,1506,200,46.64,100,23.03,30.75,1506,0
XDJA,1478,200,32.66,200,10.89,21.30,1478,0
DDWM,1467,200,36.20,200,21.73,28.70,1467,0
IGEB,1458,200,56.61,200,33.97,45.05,1458,0
PNOV,1458,100,38.18,100,22.21,29.73,1458,0
JMUB,1452,100,62.49,200,37.86,50.44,1452,0
OSCV,1451,200,48.81,200,16.27,32.07,1451,0
TRTY,1451,100,32.78,100,20.04,25.74,735,716
VAMO,1451,100,35.39,1,26.04,26.45,1351,100
TMFM,1431,200,36.39,200,12.14,23.56,1431,0
PSMG,1389,200,26.01,200,8.67,17.09,1389,0
KAPR,1374,100,33.16,200,13.08,25.89,1374,0
TTAI,1354,200,43.25,100,21.28,28.48,1354,0
GSEW,1347,100,72.41,100,47.79,61.22,1289,58
MFUL,1347,200,32.13,200,10.72,21.42,1347,0
XJUN,1346,200,46.30,100,22.94,30.66,1346,0
UMAR,1341,200,44.22,200,14.75,29.15,841,500
VFVA,1331,100,125.29,120,88.00,101.32,1331,0
BUFT,1316,200,28.72,200,9.58,18.98,1316,0
GVAL,1293,100,22.24,100,12.25,18.13,1293,0
AESR,1280,100,16.71,100,8.12,12.03,980,300
OEUR,1252,100,30.73,100,18.20,23.00,1252,0
EDEN,1246,200,135.54,100,67.42,88.31,1246,0
BAPR,1231,100,41.06,100,23.89,32.01,231,1000
IMOM,1223,200,39.68,200,13.23,26.35,1223,0
VFMO,1210,100,146.37,100,92.27,118.40,1056,154
IGHG,1180,100,86.30,100,54.40,69.73,1180,0
FAPR,1154,100,38.86,100,22.61,30.29,1154,0
NAPR,1127,100,47.12,100,27.41,36.65,127,1000
XDEC,1125,200,44.53,200,14.85,29.38,1125,0
DWLD,1118,100,31.53,100,16.54,24.70,1118,0
IEME,1118,200,41.65,200,13.89,27.77,1118,0
BNOV,1104,200,46.56,200,15.53,30.72,1104,0
ESHY,1101,200,27.93,100,12.49,18.41,1101,0
IBHG,1101,200,33.12,100,15.12,21.99,1101,0
TSLH,1100,200,38.82,100,20.73,25.74,1100,0
SATO,1067,200,10.43,200,6.27,7.97,1067,0
GOVZ,1027,100,21.08,100,10.25,15.15,1027,0
GMOM,1007,100,35.42,100,23.91,29.45,1007,0
HYGW,1000,200,60.09,200,20.04,39.61,1000,0
EWGS,979,100,73.10,200,27.66,52.94,979,0
FLIA,959,200,28.91,200,17.35,23.02,959,0
FPFD,953,200,26.59,100,16.19,21.18,953,0
DOCT,937,100,40.04,100,23.30,31.07,837,100
TMDV,935,200,72.85,100,35.93,47.74,935,0
ICOW,931,100,34.84,100,20.27,27.06,831,100
PAWZ,925,10,52.92,100,41.46,52.47,925,0
GSUS,906,100,69.86,200,28.83,56.40,906,0
DJUL,897,100,40.64,100,23.64,31.64,897,0
UJUL,895,200,39.71,200,13.24,26.23,295,600
FMIL,886,200,44.71,60,26.14,29.36,886,0
DFND,882,100,44.28,2,32.97,34.80,882,0
PSEP,867,100,34.46,100,21.96,29.33,867,0
XJH,852,200,43.56,200,26.14,34.03,852,0
ACIO,836,100,39.49,100,22.98,30.77,836,0
NJAN,836,100,49.40,100,28.73,38.35,836,0
BMAY,820,200,46.34,200,15.45,30.44,820,0
GHTA,800,200,35.18,200,11.73,23.27,800,0
UNOV,794,200,41.95,200,13.99,27.85,694,100
IMLP,784,200,23.83,200,7.95,15.73,784,0
SMMD,767,100,71.17,200,29.34,57.37,767,0
BDEC,755,100,41.88,100,24.37,32.58,755,0
DUSA,744,200,43.91,200,14.64,28.69,744,0
FDHT,736,200,29.60,200,9.87,19.43,736,0
PBSM,718,100,43.93,100,25.55,34.20,718,0
PFEB,711,100,36.42,100,21.19,28.34,711,0
MSTB,708,100,34.55,100,20.11,26.86,708,0
YPS,702,200,33.28,200,11.10,21.64,702,0
FMAR,700,100,41.44,100,24.10,32.14,700,0
PSMJ,693,200,32.08,200,10.70,21.22,593,100
MAGA,683,100,50.61,100,29.43,39.18,683,0
DUDE,650,200,35.89,200,11.97,23.91,650,0
PDEC,621,100,38.67,100,22.50,30.13,621,0
FFSG,603,200,50.98,100,24.92,33.21,603,0
QMAR,600,100,28.97,100,14.08,20.92,600,0
KNGS,595,100,26.53,100,12.89,19.08,595,0
EGIS,585,200,49.25,100,24.08,32.17,585,0
XJR,576,200,45.70,200,27.43,35.76,576,0
DFNV,572,200,36.76,200,12.26,23.94,572,0
IBHE,566,200,34.56,200,11.52,22.97,566,0
FJUL,565,200,53.92,200,17.98,35.50,565,0
EFAD,563,200,54.34,25,30.00,35.61,563,0
IPDP,531,200,24.21,200,8.08,15.80,531,0
DJUN,523,100,42.21,100,24.55,32.85,247,276
VFLQ,508,200,126.48,200,75.90,99.09,508,0
AFIF,505,200,13.43,200,4.48,8.94,505,0
PSMM,504,200,21.39,100,10.29,14.27,504,0
MSVX,500,100,31.40,100,16.47,24.38,500,0
XDAT,500,200,27.85,100,12.22,18.15,500,0
XUSP,500,200,40.50,200,13.51,26.20,500,0
DINT,497,200,24.85,200,8.29,16.42,497,0
FEDX,491,200,40.01,100,20.11,26.16,491,0
LUXE,486,10,24.05,100,15.85,23.37,486,0
HYXU,484,200,52.55,200,31.54,41.22,484,0
QTJA,475,200,30.81,200,10.28,20.07,475,0
GLOV,471,200,60.41,200,20.14,39.90,471,0
PSFO,458,200,30.87,200,10.29,20.41,458,0
XDQQ,452,200,35.94,100,19.11,23.73,252,200
HELX,442,100,43.28,100,25.17,33.68,442,0
BJUL,437,100,41.23,100,23.99,32.15,437,0
IEDI,402,200,61.25,200,20.42,39.81,402,0
FDEC,400,100,41.68,100,24.24,32.42,400,0
KOCT,400,100,33.50,200,13.12,25.99,0,400
NJUL,400,100,58.25,100,33.89,45.39,100,300
DFRA,391,200,40.53,200,13.52,26.73,391,0
PBDM,390,100,32.68,100,15.88,23.40,390,0
OUSM,388,100,43.90,100,25.53,34.13,388,0
VFMV,373,100,120.75,100,82.13,101.23,373,0
IDHD,372,200,35.80,200,11.94,23.88,372,0
PWS,372,100,39.53,100,23.00,30.75,372,0
MEAR,362,100,58.29,100,41.19,49.78,362,0
TSOC,350,200,44.65,200,14.89,29.10,350,0
FFTG,324,200,39.99,200,13.34,26.12,324,0
BOSS,316,100,33.04,200,13.12,25.59,316,0
GDMN,315,200,30.33,5,19.88,20.07,315,0
PEX,310,100,36.38,200,14.08,27.62,310,0
RESD,310,200,31.79,200,19.08,25.00,310,0
PJUN,308,100,39.35,100,22.89,30.66,5,303
FDEV,306,100,31.35,100,16.44,24.26,306,0
TFJL,300,200,31.87,200,10.63,21.16,300,0
ALFA,299,200,93.21,200,31.07,62.10,299,0
QPFF,298,200,55.95,200,18.66,37.00,298,0
UOCT,290,100,34.87,100,20.28,27.11,90,200
FSMO,289,100,29.08,100,14.13,20.99,289,0
TBJL,271,200,31.38,200,10.47,20.78,271,0
HCRB,268,200,45.02,200,27.02,35.88,268,0
NULC,266,200,53.32,200,17.78,34.82,266,0
ROCI,261,200,36.06,200,12.03,23.60,261,0
HYBL,259,200,35.73,200,21.45,28.40,259,0
FLQS,258,200,53.18,200,17.73,34.71,258,0
BUYZ,243,100,33.31,100,16.19,23.95,243,0
ESGG,240,200,193.21,200,64.41,126.60,240,0
FPAG,230,200,33.42,200,11.15,21.83,230,0
BJUN,224,200,48.71,200,16.24,31.95,200,24
JCPI,218,200,73.42,200,24.48,49.00,218,0
IETC,216,100,61.09,100,35.53,47.31,216,0
EUDV,206,200,61.86,100,30.35,40.42,206,0
HFGO,205,200,20.11,200,6.71,13.14,205,0
IBHF,200,100,31.72,100,15.42,22.88,200,0
KJUL,197,100,30.79,100,16.66,24.71,197,0
SEIM,187,200,40.45,200,13.49,26.50,187,0
NURE,182,100,43.67,100,26.37,35.26,182,0
SEIQ,176,200,40.36,200,13.46,26.33,176,0
EAOA,170,200,44.53,200,14.85,29.22,170,0
DAPR,153,100,39.18,100,22.79,30.43,153,0
TLTW,150,200,60.08,200,20.03,39.53,150,0
CSM,148,100,62.71,100,36.48,48.76,148,0
BLKC,145,200,18.20,200,6.07,11.75,145,0
DNOV,143,100,42.50,100,24.73,33.03,143,0
EWUS,137,200,48.79,200,16.27,31.67,137,0
IBMO,134,200,31.73,200,19.05,25.31,101,33
MOTE,130,200,35.64,200,11.89,23.65,130,0
WEED,129,200,14.94,100,7.67,9.58,129,0
XDSQ,128,200,37.38,200,12.46,24.68,128,0
TILT,127,100,197.98,100,126.81,159.81,127,0
XBOC,123,200,36.49,200,12.17,23.91,123,0
LEAD,121,100,64.77,200,26.73,52.36,121,0
BUFB,113,200,36.23,200,12.08,23.85,113,0
WBAT,111,100,45.66,200,18.21,36.21,111,0
QJUN,110,100,26.71,100,12.98,19.23,110,0
IVSG,108,200,16.71,200,5.58,10.90,108,0
IQM,105,100,50.35,100,29.29,39.16,105,0
PMAY,104,200,43.84,200,14.62,28.97,104,0
BBSA,103,200,60.04,200,36.03,47.97,103,0
GEMD,102,200,50.98,200,30.60,40.37,102,0
JULZ,102,200,50.91,200,16.98,33.35,102,0
RSEE,102,200,37.49,200,12.50,24.85,102,0
GDE,101,200,34.19,200,11.40,22.22,101,0
PLTL,101,200,36.58,200,12.20,23.93,101,0
CVAR,100,200,38.00,200,12.67,24.83,100,0
DBOC,100,200,43.41,100,21.38,28.65,100,0
DFHY,100,200,32.96,200,10.99,21.94,100,0
PXUS,100,200,30.93,200,10.32,20.28,100,0
QSPT,100,200,28.72,200,9.58,18.76,100,0
RTAI,100,200,33.87,200,11.30,22.33,100,0
SELV,100,200,38.49,200,12.83,25.24,100,0
XDAP,100,200,41.63,200,13.88,27.11,100,0
HSRT,98,100,49.45,100,28.76,38.43,98,0
MOTI,94,100,36.65,100,21.33,28.52,94,0
PSCW,92,200,32.29,200,10.77,21.32,92,0
IVLC,90,200,19.87,200,6.63,12.95,90,0
IAUF,88,100,57.75,100,52.01,52.89,88,0
BLDG,87,200,42.11,200,14.04,27.70,87,0
TTAC,85,100,60.97,100,36.81,49.46,85,0
ESG,82,200,151.34,200,50.45,98.93,82,0
TMFS,78,200,40.52,100,18.08,26.40,78,0
GSID,75,200,69.64,200,23.22,45.57,75,0
SMI,69,200,57.34,200,34.41,45.78,69,0
PSCX,62,200,32.04,200,10.69,21.15,62,0
IVRA,59,200,22.21,200,7.41,14.62,59,0
XTOC,59,200,36.12,200,12.05,23.28,59,0
THY,58,200,34.88,200,11.63,23.04,58,0
JBBB,54,200,59.25,200,35.55,47.29,54,0
STLV,50,200,42.27,1,27.19,27.69,50,0
SPMV,49,200,58.45,200,19.49,38.30,49,0
BUFF,45,100,44.55,100,25.91,34.58,45,0
HAUS,36,200,28.16,100,14.02,18.47,36,0
PUNK,36,200,30.30,200,10.11,19.78,36,0
MOTG,30,200,43.27,200,25.97,34.32,30,0
PSMC,27,200,18.78,200,6.26,12.43,27,0
CLSE,26,200,22.80,200,7.61,15.06,26,0
FNOV,26,200,55.16,200,18.39,36.43,26,0
FUNL,26,200,51.01,200,17.01,33.27,26,0
ISVL,23,200,45.30,200,15.11,29.73,23,0
VIRS,22,200,43.00,200,14.34,28.20,22,0
UAUG,18,100,34.68,100,20.18,27.00,18,0
FDEM,17,200,32.43,100,14.24,21.54,17,0
FAIL,16,100,30.00,100,14.58,21.39,16,0
WLDR,14,200,36.02,200,12.01,23.45,14,0
BUFQ,11,200,33.79,200,11.27,22.14,11,0
GCLN,11,200,62.65,200,20.89,41.38,11,0
PJUL,11,100,39.49,100,22.98,30.76,9,2
GLDB,10,200,30.12,200,10.04,19.66,10,0
QTAP,9,200,41.52,200,13.85,27.32,9,0
VWID,8,200,30.07,200,18.05,23.91,8,0
LYFE,7,200,46.45,100,20.80,30.51,7,0
FOMO,5,200,27.52,200,9.18,18.35,5,0
MAAX,5,200,27.16,200,16.30,21.68,5,0
PBUS,5,100,53.33,100,31.02,41.34,5,0
VMOT,5,100,31.72,100,16.63,24.62,5,0
XBJA,5,200,34.75,200,11.59,23.00,5,0
AMER,4,200,44.58,200,14.87,29.25,4,0
STLG,3,200,50.85,200,16.96,33.36,3,0
WDNA,3,200,28.81,100,12.81,19.00,3,0
DJAN,2,100,40.54,100,23.58,31.63,2,0
KWT,2,200,54.46,200,18.16,36.70,2,0
PSMB,2,200,23.28,100,12.65,15.28,2,0
RODE,2,200,37.13,200,12.38,24.52,2,0
IGLD,1,100,26.32,100,12.79,19.06,1,0
IVDG,1,200,16.33,200,5.45,10.70,1,0
LIV,1,200,28.64,200,9.55,18.78,1,0
MBBB,1,200,26.51,200,15.91,21.15,1,0
MSTQ,1,200,36.03,200,12.02,23.51,1,0
NUDV,1,200,37.66,200,12.56,24.92,1,0
PSMR,1,200,32.81,200,10.94,21.58,1,0
ROMO,1,100,32.83,200,12.84,25.68,1,0
SHAG,1,200,59.55,200,35.74,47.56,1,0
TCTL,1,200,44.80,200,14.94,29.85,1,0
XBAP,1,200,40.22,200,13.41,26.41,1,0
ACSI,0,200,71.81,200,23.94,0.00,0,0
APRZ,0,200,39.17,200,13.06,0.00,0,0
ARCM,0,200,148.96,200,49.66,0.00,0,0
BGLD,0,200,26.60,200,8.87,0.00,0,0
BOB,0,200,32.96,200,10.99,0.00,0,0
CFCV,0,200,47.99,200,16.00,0.00,0,0
DBJA,0,200,39.71,200,13.24,0.00,0,0
DECZ,0,200,42.42,200,14.15,0.00,0,0
DSJA,0,200,39.69,200,13.24,0.00,0,0
DSOC,0,200,45.47,200,15.16,0.00,0,0
EAOK,0,200,36.90,200,12.31,0.00,0,0
EAOM,0,200,38.49,200,12.84,0.00,0,0
EAOR,0,200,41.45,200,13.82,0.00,0,0
EMDV,0,100,60.50,100,35.20,0.00,0,0
EOPS,0,200,24.22,200,8.08,0.00,0,0
ESCR,0,200,28.20,200,9.40,0.00,0,0
ESEB,0,200,25.18,200,8.40,0.00,0,0
FEBZ,0,200,41.70,200,13.91,0.00,0,0
FFHG,0,100,42.82,100,24.92,0.00,0,0
FIBR,0,4,92.50,200,65.42,0.00,0,0
FLTN,0,200,36.72,200,12.25,0.00,0,0
GPAL,0,200,52.33,200,17.45,0.00,0,0
GSEE,0,200,62.12,200,20.71,0.00,0,0
HEET,0,200,35.26,200,11.76,0.00,0,0
HSUN,0,200,42.50,200,25.51,0.00,0,0
IMFL,0,200,31.08,200,10.36,0.00,0,0
IPPP,0,200,15.93,200,5.32,0.00,0,0
JANZ,0,200,40.90,200,13.64,0.00,0,0
JUNZ,0,200,37.81,200,12.61,0.00,0,0
LCF,0,200,38.97,200,13.00,0.00,0,0
LQDW,0,200,60.15,200,20.06,0.00,0,0
MARZ,0,200,38.68,200,12.90,0.00,0,0
MAYZ,0,200,36.80,200,12.27,0.00,0,0
MBND,0,200,40.81,100,20.33,0.00,0,0
MBNE,0,200,44.74,200,14.92,0.00,0,0
MDEV,0,200,23.93,200,14.37,0.00,0,0
MIG,0,200,26.66,200,16.00,0.00,0,0
MINN,0,200,33.29,100,14.91,0.00,0,0
MRSK,0,200,41.71,200,13.91,0.00,0,0
MSMR,0,200,32.99,200,11.00,0.00,0,0
NOVZ,0,200,47.16,200,15.73,0.00,0,0
OBND,0,200,33.59,200,20.16,0.00,0,0
OCTZ,0,200,45.52,200,15.18,0.00,0,0
PBND,0,200,28.54,200,17.13,0.00,0,0
PLRG,0,200,38.24,200,12.75,0.00,0,0
PSCJ,0,200,30.25,200,10.09,0.00,0,0
PSCQ,0,200,30.33,200,10.12,0.00,0,0
PSFD,0,200,34.88,200,11.63,0.00,0,0
PSFJ,0,200,32.65,200,10.89,0.00,0,0
PSFM,0,200,33.62,200,11.21,0.00,0,0
PSMD,0,200,32.87,200,10.96,0.00,0,0
PSMO,0,200,30.81,200,10.27,0.00,0,0
QCON,0,200,52.96,200,31.78,0.00,0,0
QTOC,0,200,32.82,200,10.95,0.00,0,0
RDFI,0,200,36.04,200,12.02,0.00,0,0
REC,0,200,32.46,200,10.82,0.00,0,0
RESE,0,200,35.61,200,21.38,0.00,0,0
RODI,0,200,129.85,200,77.91,0.00,0,0
RSX,0,0,0.00,0,0.00,0.00,0,0
RSXJ,0,0,0.00,0,0.00,0.00,0,0
SEIV,0,200,38.19,200,12.74,0.00,0,0
SFIG,0,200,59.76,200,35.86,0.00,0,0
TSJA,0,200,39.47,200,13.16,0.00,0,0
TUSI,0,200,31.31,200,18.80,0.00,0,0
UDEC,0,200,43.08,100,21.29,0.00,0,0
USEQ,0,200,53.13,200,17.72,0.00,0,0
VMAT,0,200,36.79,200,12.27,0.00,0,0
WFIG,0,200,57.28,200,34.37,0.00,0,0
WIL,0,200,116.48,200,69.90,0.00,0,0
XDJL,0,200,36.73,200,12.25,0.00,0,0
XDOC,0,200,35.66,200,11.89,0.00,0,0
XEMD,0,200,50.68,200,30.42,0.00,0,0
XTAP,0,200,41.52,100,20.28,0.00,0,0
XTJA,0,200,32.75,200,10.92,0.00,0,0
YDEC,0,200,28.90,200,9.64,0.00,0,0
YMAR,0,200,27.71,100,12.32,0.00,0,0
YSEP,0,200,26.87,200,8.96,0.00,0,0